NO ./textures/Wall/forest.png
SO ./textures/Wall/forest.png
WE ./textures/Wall/forest.png


F 34,,139,34
EA ./textures/Wall/forest.png
C 135,206,235

    1111111
    10100011111111111111111111111111111111111111111111111111111111111
    10100000000000000000000000000000000000000000000000000000000000001  
    10100000000000000000000000000000000000000000000000000000000000001   
    10000000000000000000000000000000000000000000000000000000000000001   
    100E011111111111111111111111111111111111111111111111111100000001   
    1111111                                                 11111111                                                                              
    