111111111
11E00P0C1
111111111
