1111111111111111111111
1E0000000000000C0000C1
1010010100P00000101001
1010010010101010001001
10000000C00C0000000011
1111111111111111111111
