11111111111111
110010C0001001
1P000001110011
1001000C000011
11111111111111