111111111
11100P0CE11
111111111
