1111111111
1P11010001
1011011101
1000111001
1111C10011
1111010111
11110000E1
1111111111
