11111111111111
110010C00000C1
100E0001110011
1P000000E00011
11111111111111